########____########
#__________________#
#__________________#
#__________________#
#__________________#
#__________________#
#__________________#
#__________________#
____________________
____________________
____________________
____________________
#__________________#
#__________________#
#__________________#
#__________________#
#__________________#
#__________________#
#__________________#
########____########