####################
#__________________#
#__________________#
#__________________#
#__________________#
#____##______##____#
#____##______##____#
#__________________#
#__________________#
#__________________#
#__________________#
#__________________#
#__________________#
#____##______##____#
#____##______##____#
#__________________#
#__________________#
#__________________#
#__________________#
####################